20
20
5 6 7 8 9 12 1 1 1 1 1 1 1 1 1 19 19 19 19 19 
1 0 0 0 0 0 0 0 0 0 0 0 0 0 0 0 0 0 0 1 
1 0 0 0 0 0 0 0 0 0 0 0 0 0 0 0 0 0 0 1 
1 0 0 2 2 0 0 0 0 2 0 0 3 0 0 0 0 0 0 1 
1 0 0 0 2 0 0 0 0 2 0 0 0 0 0 0 0 0 0 1 
1 0 0 0 2 0 0 0 0 2 0 0 0 0 0 0 0 0 0 1 
1 0 0 0 2 2 2 2 2 2 0 0 2 0 0 0 0 0 0 1 
1 0 0 0 2 0 0 0 0 2 0 0 2 0 0 0 0 0 0 1 
1 0 0 0 2 0 0 4 0 2 0 0 2 0 0 0 0 0 0 1 
1 0 0 0 2 0 0 0 0 2 2 2 2 2 2 2 2 2 2 1 
1 0 0 0 2 0 0 0 0 2 0 0 2 0 0 0 0 0 2 1 
1 0 0 0 0 0 0 0 0 0 0 0 0 0 0 0 0 0 2 1 
1 0 0 0 0 0 0 0 0 0 0 0 0 0 0 0 0 0 2 1 
1 0 0 0 0 0 0 0 0 0 0 0 0 0 0 0 0 0 2 1 
1 0 0 0 0 0 0 0 0 0 0 0 0 0 0 0 0 0 2 1 
1 0 0 0 0 0 0 0 0 0 0 0 0 0 0 0 0 0 2 1 
1 0 0 0 0 0 0 0 0 0 0 0 0 0 0 0 0 0 2 1 
1 0 0 0 0 0 0 0 0 0 0 0 0 0 0 0 0 0 2 1 
1 0 0 0 0 0 0 0 0 0 0 0 0 0 0 0 0 0 2 1 
1 1 1 1 1 1 1 1 1 1 1 1 1 1 1 1 1 1 1 1 